1111111111111
1C010000001C1
1P00000000001
100000E000001
1111111111111