1111111111111
1000000000C11
1010011111001
1P1011E000001
1111111111111